Nearchou Ioannis
Moats	Joshua
Waling	Linden
Martin	Dylan
Singh	Shahbaaz
Kirksey	Dustin
Holmes	Travis
Le	Nam
Robbins	Dustin
Maki	Kristina
Scott	Bradley
Nguyen	An
Gray	Xavier
Goble	Timothy
Beitello	Husam
Birge	Kenny
Schultz	Trent
Radwan	AhmedAbdelwahab
True	Justin
Schutz	Matthew
Desnoyer	Daniel
Ragotzy	Austin
Kubath	Jonah
McInnis	Logan
Smith	Greg
Greener	Bryan
Hinga	Timothy
Albert	Christian
Farran	Andrew
Wilson	James
Harker	Thomas
Cooke	Brittain
Jacobs	Mitchell
Sanchez	Oliver
Wagerson	Henry
Hamilton	Ryan
Siciliano	Nikolas
Misner	Harley
Aerts	Collin
Kessler	Adam
VanderHorstValette	Oscar
Ghali	MariamAdel
Rodriguez	Brandon
Arundel	Lawrence
Kahrl	Allin
Wengert	Eric
Sziede	Joshua
Johnson	Steven
Gravlin	Tyler
Albert	Christian
Bodurka	Alexander
Chandler	Josh
